ASCII	ASCII	font-family:ASCII;font-weight:500;
AmiciLogo	AmiciLogo	font-family:LukasSvatba;font-weight:500;
AmiciLogoBold	AmiciLogoBold	font-family:LukasSvatba;font-weight:bold;
AmiciLogoBoldOblique	AmiciLogoBoldSlant	font-family:LukasSvatba;font-weight:bold;font-style:oblique;
AmiciLogoBoldReverseOblique	AmiciLogoBoldRslant	font-family:LukasSvatba;font-weight:bold;font-style:oblique;
AmiciLogoOblique	AmiciLogoSlant	font-family:LukasSvatba;font-style:oblique;
AmiciLogoReverseOblique	AmiciLogoRslant	font-family:LukasSvatba;font-style:oblique;
AndaleMono	Andale_Mono	font-family:Andale Mono;
AntykwaTorunska-Bold	AntykwaTorunska-Bold	font-family:AntykwaTorunska;font-weight:bold;
AntykwaTorunska-BoldItalic	AntykwaTorunska-BoldItalic	font-family:AntykwaTorunska;font-weight:bold;font-style:italic;
AntykwaTorunska-Italic	AntykwaTorunska-Italic	font-family:AntykwaTorunska;font-style:italic;
AntykwaTorunska-Regular	AntykwaTorunska-Regular	font-family:AntykwaTorunska;
AntykwaTorunskaCond-Bold	AntykwaTorunskaCond-Bold	font-family:AntykwaTorunskaCond;font-weight:bold;
AntykwaTorunskaCond-BoldItalic	AntykwaTorunskaCond-BoldItalic	font-family:AntykwaTorunskaCond;font-weight:bold;font-style:italic;
AntykwaTorunskaCond-Italic	AntykwaTorunskaCond-Italic	font-family:AntykwaTorunskaCond;font-style:italic;
AntykwaTorunskaCond-Regular	AntykwaTorunskaCond-Regular	font-family:AntykwaTorunskaCond;
AntykwaTorunskaCondLight-Italic	AntykwaTorunskaCondLight-Italic	font-family:AntykwaTorunskaCond;font-weight:300;font-style:italic;
AntykwaTorunskaCondLight-Regular	AntykwaTorunskaCondLight-Regular	font-family:AntykwaTorunskaCond;font-weight:300;
AntykwaTorunskaCondMed-Italic	AntykwaTorunskaCondMed-Italic	font-family:AntykwaTorunskaCond;font-style:italic;
AntykwaTorunskaCondMed-Regular	AntykwaTorunskaCondMed-Regular	font-family:AntykwaTorunskaCond;
AntykwaTorunskaLight-Italic	AntykwaTorunskaLight-Italic	font-family:AntykwaTorunskaLigh;font-weight:300;font-style:italic;
AntykwaTorunskaLight-Regular	AntykwaTorunskaLight-Regular	font-family:AntykwaTorunskaLigh;font-weight:300;
AntykwaTorunskaMed-Italic	AntykwaTorunskaMed-Italic	font-family:AntykwaTorunskaMed;font-style:italic;
AntykwaTorunskaMed-Regular	AntykwaTorunskaMed-Regular	font-family:AntykwaTorunskaMed;
Archaic-Aramaic	aram10	font-family:Archaic;
Archaic-Cypriot	cypr10	font-family:Archaic;
Archaic-Etruscan	etr10	font-family:Archaic;
Archaic-Futharc	fut10	font-family:Archaic;
Archaic-Greek-4th-Century-BC	givbc10	font-family:Archaic;
Archaic-Greek-6th-Century-BC	gvibc10	font-family:Archaic;
Archaic-Linear-B	linb10	font-family:Archaic;
Archaic-Nabatean	nab10	font-family:Archaic;
Archaic-OandS	oandsu10	font-family:Archaic;
Archaic-OandS-Italic	oandsi10	font-family:Archaic;font-style:italic;
Archaic-Old-Persian	copsn10	font-family:Archaic;
Archaic-Phoenician	phnc10	font-family:Archaic;
Archaic-Poor-Mans-Hieroglyphs	pmhg	font-family:Archaic;
Archaic-ProtoSemitic	proto10	font-family:Archaic;
Archaic-South-Arabian	sarab10	font-family:Archaic;
Archaic-Ugaritic-Cuneiform	cugar10	font-family:Archaic;
ArevSans-Bold	ArevSans-Bold	font-family:Arev Sans;font-weight:bold;
ArevSans-BoldOblique	ArevSans-BoldOblique	font-family:Arev Sans;font-weight:bold;font-style:oblique;
ArevSans-Oblique	ArevSans-Oblique	font-family:Arev Sans;font-style:oblique;
ArevSans-Roman	ArevSans-Roman	font-family:Arev Sans;
Arial-Black	Arial_Black	font-family:Arial Black;
Arial-BoldItalicMT	Arial_Bold_Italic	font-family:Arial;font-weight:bold;font-style:italic;
Arial-BoldMT	Arial_Bold	font-family:Arial;font-weight:bold;
Arial-ItalicMT	Arial_Italic	font-family:Arial;font-style:italic;
ArialMT	Arial	font-family:Arial;
Augie	augie___	font-family:Augie;font-weight:500;
AuriocusKalligraphicus	AuriocusKalligraphicus	font-family:AuriocusKalligraphicus;font-weight:500;
AuriocusKalligraphicusBold	AuriocusKalligraphicusBold	font-family:AuriocusKalligraphicus;font-weight:bold;
AuriocusKalligraphicusBoldOblique	AuriocusKalligraphicusBoldSlant	font-family:AuriocusKalligraphicus;font-weight:bold;font-style:oblique;
AuriocusKalligraphicusBoldReverseOblique	AuriocusKalligraphicusBoldRslant	font-family:AuriocusKalligraphicus;font-weight:bold;font-style:oblique;
AuriocusKalligraphicusOblique	AuriocusKalligraphicusSlant	font-family:AuriocusKalligraphicus;font-style:oblique;
AuriocusKalligraphicusReverseOblique	AuriocusKalligraphicusRslant	font-family:AuriocusKalligraphicus;font-style:oblique;
BeraSans-Bold	fvsb8a	font-family:Bera Sans;font-weight:bold;
BeraSans-BoldOblique	fvsbo8a	font-family:Bera Sans;font-weight:bold;font-style:oblique;
BeraSans-Oblique	fvsro8a	font-family:Bera Sans;font-style:oblique;
BeraSans-Roman	fvsr8a	font-family:Bera Sans;
BeraSansMono-Bold	fvmb8a	font-family:Bera Sans Mono;font-weight:bold;
BeraSansMono-BoldOb	fvmbo8a	font-family:Bera Sans Mono;font-weight:bold;font-style:italic;
BeraSansMono-Oblique	fvmro8a	font-family:Bera Sans Mono;font-style:oblique;
BeraSansMono-Roman	fvmr8a	font-family:Bera Sans Mono;
BeraSerif-Bold	fveb8a	font-family:Bera Serif;font-weight:bold;
BeraSerif-Roman	fver8a	font-family:Bera Serif;
BitstreamVeraSans-Bold	VeraBd	font-family:Bitstream Vera Sans;font-weight:bold;
BitstreamVeraSans-BoldOblique	VeraBI	font-family:Bitstream Vera Sans;font-weight:bold;font-style:oblique;
BitstreamVeraSans-Oblique	VeraIt	font-family:Bitstream Vera Sans;font-style:oblique;
BitstreamVeraSans-Roman	Vera	font-family:Bitstream Vera Sans;
BitstreamVeraSansMono-Bold	VeraMoBd	font-family:Bitstream Vera Sans Mono;font-weight:bold;
BitstreamVeraSansMono-BoldOb	VeraMoBI	font-family:Bitstream Vera Sans Mono;font-weight:bold;font-style:italic;
BitstreamVeraSansMono-Oblique	VeraMoIt	font-family:Bitstream Vera Sans Mono;font-style:oblique;
BitstreamVeraSansMono-Roman	VeraMono	font-family:Bitstream Vera Sans Mono;
BitstreamVeraSerif-Bold	VeraSeBd	font-family:Bitstream Vera Serif;font-weight:bold;
BitstreamVeraSerif-Roman	VeraSe	font-family:Bitstream Vera Serif;
BrushScriptX-Italic	BrushScriptX-Italic	font-family:BrushScriptX;font-weight:500;font-style:italic;
CMB10	cmb10	font-family:Computer Modern;font-weight:bold;
CMBSY10	cmbsy10	font-family:Computer Modern;font-weight:bold;font-style:italic;
CMBSY5	cmbsy5	font-family:Computer Modern;font-weight:bold;font-style:italic;
CMBSY7	cmbsy7	font-family:Computer Modern;font-weight:bold;font-style:italic;
CMBX10	cmbx10	font-family:Computer Modern;font-weight:bold;
CMBX12	cmbx12	font-family:Computer Modern;font-weight:bold;
CMBX5	cmbx5	font-family:Computer Modern;font-weight:bold;
CMBX6	cmbx6	font-family:Computer Modern;font-weight:bold;
CMBX7	cmbx7	font-family:Computer Modern;font-weight:bold;
CMBX8	cmbx8	font-family:Computer Modern;font-weight:bold;
CMBX9	cmbx9	font-family:Computer Modern;font-weight:bold;
CMBXSL10	cmbxsl10	font-family:Computer Modern;font-weight:bold;font-style:italic;
CMBXTI10	cmbxti10	font-family:Computer Modern;font-weight:bold;font-style:italic;
CMCSC10	cmcsc10	font-family:Computer Modern;font-weight:500;
CMDUNH10	cmdunh10	font-family:Computer Modern;font-weight:500;
CMEX10	cmex10	font-family:Computer Modern;font-weight:500;
CMFF10	cmff10	font-family:Computer Modern;font-weight:500;font-style:italic;
CMFI10	cmfi10	font-family:Computer Modern;font-weight:500;font-style:italic;
CMFIB8	cmfib8	font-family:Computer Modern;font-weight:bold;
CMINCH	cminch	font-family:Computer Modern;font-weight:bold;
CMITT10	cmitt10	font-family:Computer Modern;font-weight:500;font-style:italic;
CMMI10	cmmi10	font-family:Computer Modern;font-weight:500;font-style:italic;
CMMI12	cmmi12	font-family:Computer Modern;font-weight:500;font-style:italic;
CMMI5	cmmi5	font-family:Computer Modern;font-weight:500;font-style:italic;
CMMI6	cmmi6	font-family:Computer Modern;font-weight:500;font-style:italic;
CMMI7	cmmi7	font-family:Computer Modern;font-weight:500;font-style:italic;
CMMI8	cmmi8	font-family:Computer Modern;font-weight:500;font-style:italic;
CMMI9	cmmi9	font-family:Computer Modern;font-weight:500;font-style:italic;
CMMIB10	cmmib10	font-family:Computer Modern;font-weight:bold;font-style:italic;
CMMIB5	cmmib5	font-family:Computer Modern;font-weight:bold;font-style:italic;
CMMIB7	cmmib7	font-family:Computer Modern;font-weight:bold;font-style:italic;
CMR10	cmr10	font-family:Computer Modern;font-weight:500;
CMR12	cmr12	font-family:Computer Modern;font-weight:500;
CMR17	cmr17	font-family:Computer Modern;font-weight:500;
CMR5	cmr5	font-family:Computer Modern;font-weight:500;
CMR6	cmr6	font-family:Computer Modern;font-weight:500;
CMR7	cmr7	font-family:Computer Modern;font-weight:500;
CMR8	cmr8	font-family:Computer Modern;font-weight:500;
CMR9	cmr9	font-family:Computer Modern;font-weight:500;
CMRoman-Bold	fcmb8a	font-family:CM Roman;font-weight:bold;
CMRoman-BoldItalic	fcmbi8a	font-family:CM Roman;font-weight:bold;font-style:italic;
CMRoman-BoldItalicOsF	fcmbij8a	font-family:CM Roman;font-weight:bold;font-style:italic;
CMRoman-BoldSC	fcmbc8a	font-family:CM Roman;font-weight:bold;
CMRoman-Italic	fcmri8a	font-family:CM Roman;font-style:italic;
CMRoman-ItalicOsF	fcmrij8a	font-family:CM Roman;font-style:italic;
CMRoman-Regular	fcmr8a	font-family:CM Roman;
CMRoman-RegularSC	fcmrc8a	font-family:CM Roman;
CMRomanAsian-Bold	fcmb6y	font-family:CM Roman Asian;font-weight:bold;
CMRomanAsian-BoldItalic	fcmbi6y	font-family:CM Roman Asian;font-weight:bold;font-style:italic;
CMRomanAsian-BoldItalicOsF	fcmbij6y	font-family:CM Roman Asian;font-weight:bold;font-style:italic;
CMRomanAsian-BoldSC	fcmbc6y	font-family:CM Roman Asian;font-weight:bold;
CMRomanAsian-Italic	fcmri6y	font-family:CM Roman Asian;font-style:italic;
CMRomanAsian-ItalicOsF	fcmrij6y	font-family:CM Roman Asian;font-style:italic;
CMRomanAsian-Regular	fcmr6y	font-family:CM Roman Asian;
CMRomanAsian-RegularSC	fcmrc6y	font-family:CM Roman Asian;
CMRomanCyrillic-Bold	fcmb6z	font-family:CM Roman Cyrillic;font-weight:bold;
CMRomanCyrillic-BoldItalic	fcmbi6z	font-family:CM Roman Cyrillic;font-weight:bold;font-style:italic;
CMRomanCyrillic-BoldItalicOsF	fcmbij6z	font-family:CM Roman Cyrillic;font-weight:bold;font-style:italic;
CMRomanCyrillic-BoldSC	fcmbc6z	font-family:CM Roman Cyrillic;font-weight:bold;
CMRomanCyrillic-Italic	fcmri6z	font-family:CM Roman Cyrillic;font-style:italic;
CMRomanCyrillic-ItalicOsF	fcmrij6z	font-family:CM Roman Cyrillic;font-style:italic;
CMRomanCyrillic-Regular	fcmr6z	font-family:CM Roman Cyrillic;
CMRomanCyrillic-RegularSC	fcmrc6z	font-family:CM Roman Cyrillic;
CMRomanGreek-Bold	fcmbpg	font-family:CM Roman Greek;font-weight:bold;
CMRomanGreek-BoldItalic	fcmbipg	font-family:CM Roman Greek;font-weight:bold;font-style:italic;
CMRomanGreek-BoldItalicOsF	fcmbijpg	font-family:CM Roman Greek;font-weight:bold;font-style:italic;
CMRomanGreek-BoldSC	fcmbcpg	font-family:CM Roman Greek;font-weight:bold;
CMRomanGreek-Italic	fcmripg	font-family:CM Roman Greek;font-style:italic;
CMRomanGreek-ItalicOsF	fcmrijpg	font-family:CM Roman Greek;font-style:italic;
CMRomanGreek-Regular	fcmrpg	font-family:CM Roman Greek;
CMRomanGreek-RegularSC	fcmrcpg	font-family:CM Roman Greek;
CMSL10	cmsl10	font-family:Computer Modern;font-weight:500;font-style:italic;
CMSL12	cmsl12	font-family:Computer Modern;font-weight:500;font-style:italic;
CMSL8	cmsl8	font-family:Computer Modern;font-weight:500;font-style:italic;
CMSL9	cmsl9	font-family:Computer Modern;font-weight:500;font-style:italic;
CMSLTT10	cmsltt10	font-family:Computer Modern;font-weight:500;font-style:italic;
CMSS10	cmss10	font-family:Computer Modern;font-weight:500;
CMSS12	cmss12	font-family:Computer Modern;font-weight:500;
CMSS17	cmss17	font-family:Computer Modern;font-weight:500;
CMSS8	cmss8	font-family:Computer Modern;font-weight:500;
CMSS9	cmss9	font-family:Computer Modern;font-weight:500;
CMSSBX10	cmssbx10	font-family:Computer Modern;font-weight:bold;
CMSSDC10	cmssdc10	font-family:Computer Modern;font-weight:500;
CMSSI10	cmssi10	font-family:Computer Modern;font-weight:500;font-style:italic;
CMSSI12	cmssi12	font-family:Computer Modern;font-weight:500;font-style:italic;
CMSSI17	cmssi17	font-family:Computer Modern;font-weight:500;font-style:italic;
CMSSI8	cmssi8	font-family:Computer Modern;font-weight:500;font-style:italic;
CMSSI9	cmssi9	font-family:Computer Modern;font-weight:500;font-style:italic;
CMSSQ8	cmssq8	font-family:Computer Modern;font-weight:500;
CMSSQI8	cmssqi8	font-family:Computer Modern;font-weight:500;font-style:italic;
CMSY10	cmsy10	font-family:Computer Modern;font-weight:500;font-style:italic;
CMSY5	cmsy5	font-family:Computer Modern;font-weight:500;font-style:italic;
CMSY6	cmsy6	font-family:Computer Modern;font-weight:500;font-style:italic;
CMSY7	cmsy7	font-family:Computer Modern;font-weight:500;font-style:italic;
CMSY8	cmsy8	font-family:Computer Modern;font-weight:500;font-style:italic;
CMSY9	cmsy9	font-family:Computer Modern;font-weight:500;font-style:italic;
CMSans-Bold	fcsb8a	font-family:CM Sans;font-weight:bold;
CMSans-BoldSlanted	fcsbo8a	font-family:CM Sans;font-weight:bold;font-style:oblique;
CMSans-Regular	fcsr8a	font-family:CM Sans;
CMSans-Slanted	fcsro8a	font-family:CM Sans;font-style:oblique;
CMSansAsian-Bold	fcsb6y	font-family:CM Sans Asian;font-weight:bold;
CMSansAsian-BoldSlanted	fcsbo6y	font-family:CM Sans Asian;font-weight:bold;font-style:oblique;
CMSansAsian-Regular	fcsr6y	font-family:CM Sans Asian;
CMSansAsian-Slanted	fcsro6y	font-family:CM Sans Asian;font-style:oblique;
CMSansCyrillic-Bold	fcsb6z	font-family:CM Sans Cyrillic;font-weight:bold;
CMSansCyrillic-BoldSlanted	fcsbo6z	font-family:CM Sans Cyrillic;font-weight:bold;font-style:oblique;
CMSansCyrillic-Regular	fcsr6z	font-family:CM Sans Cyrillic;
CMSansCyrillic-Slanted	fcsro6z	font-family:CM Sans Cyrillic;font-style:oblique;
CMSansGreek-Bold	fcsbpg	font-family:CM Sans Greek;font-weight:bold;
CMSansGreek-BoldSlanted	fcsbopg	font-family:CM Sans Greek;font-weight:bold;font-style:oblique;
CMSansGreek-Regular	fcsrpg	font-family:CM Sans Greek;
CMSansGreek-Slanted	fcsropg	font-family:CM Sans Greek;font-style:oblique;
CMTCSC10	cmtcsc10	font-family:Computer Modern;font-weight:500;
CMTEX10	cmtex10	font-family:Computer Modern;font-weight:500;
CMTEX8	cmtex8	font-family:Computer Modern;font-weight:500;
CMTEX9	cmtex9	font-family:Computer Modern;font-weight:500;
CMTI10	cmti10	font-family:Computer Modern;font-weight:500;font-style:italic;
CMTI12	cmti12	font-family:Computer Modern;font-weight:500;font-style:italic;
CMTI7	cmti7	font-family:Computer Modern;font-weight:500;font-style:italic;
CMTI8	cmti8	font-family:Computer Modern;font-weight:500;font-style:italic;
CMTI9	cmti9	font-family:Computer Modern;font-weight:500;font-style:italic;
CMTT10	cmtt10	font-family:Computer Modern;font-weight:500;
CMTT12	cmtt12	font-family:Computer Modern;font-weight:500;
CMTT8	cmtt8	font-family:Computer Modern;font-weight:500;
CMTT9	cmtt9	font-family:Computer Modern;font-weight:500;
CMTypewriter-Italic	fctri8a	font-family:CM Typewriter;font-style:italic;
CMTypewriter-ItalicOsF	fctrij8a	font-family:CM Typewriter;font-style:italic;
CMTypewriter-Regular	fctr8a	font-family:CM Typewriter;
CMTypewriter-RegularSC	fctrc8a	font-family:CM Typewriter;
CMTypewriterAsian-Italic	fctri6y	font-family:CM Typewriter Asian;font-style:italic;
CMTypewriterAsian-ItalicOsF	fctrij6y	font-family:CM Typewriter Asian;font-style:italic;
CMTypewriterAsian-Regular	fctr6y	font-family:CM Typewriter Asian;
CMTypewriterAsian-RegularSC	fctrc6y	font-family:CM Typewriter Asian;
CMTypewriterCyrillic-Italic	fctri6z	font-family:CM Typewriter Cyrillic;font-style:italic;
CMTypewriterCyrillic-ItalicOsF	fctrij6z	font-family:CM Typewriter Cyrillic;font-style:italic;
CMTypewriterCyrillic-Regular	fctr6z	font-family:CM Typewriter Cyrillic;
CMTypewriterCyrillic-RegularSC	fctrc6z	font-family:CM Typewriter Cyrillic;
CMTypewriterGreek-Italic	fctripg	font-family:CM Typewriter Greek;font-style:italic;
CMTypewriterGreek-ItalicOsF	fctrijpg	font-family:CM Typewriter Greek;font-style:italic;
CMTypewriterGreek-Regular	fctrpg	font-family:CM Typewriter Greek;
CMTypewriterGreek-RegularSC	fctrcpg	font-family:CM Typewriter Greek;
CMU10	cmu10	font-family:Computer Modern;font-weight:500;
CMVTT10	cmvtt10	font-family:Computer Modern;font-weight:500;
CenturySchL-Bold	uncb8a	font-family:Century Schoolbook L;font-weight:bold;
CenturySchL-BoldItal	uncbi8a	font-family:Century Schoolbook L;font-weight:bold;font-style:italic;
CenturySchL-Ital	uncri8a	font-family:Century Schoolbook L;font-style:italic;
CenturySchL-Roma	uncr8a	font-family:Century Schoolbook L;
CharterBT-Bold	c0632bt_	font-family:Bitstream Charter;font-weight:bold;
CharterBT-BoldItalic	c0633bt_	font-family:Bitstream Charter;font-weight:bold;font-style:italic;
CharterBT-Italic	c0649bt_	font-family:Bitstream Charter;font-style:italic;
CharterBT-Roman	c0648bt_	font-family:Bitstream Charter;
Cherokee-Bold	Cherokee-Bold	font-family:Cherokee;font-weight:bold;
ComicSansMS	Comic_Sans_MS	font-family:Comic Sans MS;
ComicSansMS-Bold	Comic_Sans_MS_Bold	font-family:Comic Sans MS;font-weight:bold;
ComputerModern-Sans-Bold-Oblique	cmssbxo10	font-family:Computer;font-weight:bold;font-style:oblique;
Courier	pcrr8a	font-family:Courier;
Courier-Bold	pcrb8a	font-family:Courier;font-weight:bold;
Courier-BoldItalic	pcrbo8a	font-family:Courier;font-weight:bold;font-style:italic;
Courier-Italic	pcrro8a	font-family:Courier;font-style:italic;
Courier10PitchBT-Bold	c0583bt_	font-family:Courier 10 Pitch;font-weight:bold;
Courier10PitchBT-BoldItalic	c0611bt_	font-family:Courier 10 Pitch;font-weight:bold;font-style:italic;
Courier10PitchBT-Italic	c0582bt_	font-family:Courier 10 Pitch;font-style:italic;
Courier10PitchBT-Roman	c0419bt_	font-family:Courier 10 Pitch;
CourierNewPS-BoldItalicMT	Courier_New_Bold_Italic	font-family:Courier New;font-weight:bold;font-style:italic;
CourierNewPS-BoldMT	Courier_New_Bold	font-family:Courier New;font-weight:bold;
CourierNewPS-ItalicMT	Courier_New_Italic	font-family:Courier New;font-style:italic;
CourierNewPSMT	Courier_New	font-family:Courier New;
DejaVuSans	DejaVuSans	font-family:DejaVu Sans;
DejaVuSans-Bold	DejaVuSans-Bold	font-family:DejaVu Sans;font-weight:bold;
DejaVuSans-BoldOblique	DejaVuSans-BoldOblique	font-family:DejaVu Sans;font-weight:bold;font-style:oblique;
DejaVuSans-ExtraLight	DejaVuSans-ExtraLight	font-family:DejaVu Sans Light;font-weight:200;
DejaVuSans-Oblique	DejaVuSans-Oblique	font-family:DejaVu Sans;font-style:oblique;
DejaVuSansCondensed	DejaVuSansCondensed	font-family:DejaVu Sans Condensed;font-stretch:semi-condensed;
DejaVuSansCondensed-Bold	DejaVuSansCondensed-Bold	font-family:DejaVu Sans Condensed;font-weight:bold;font-stretch:semi-condensed;
DejaVuSansCondensed-BoldOblique	DejaVuSansCondensed-BoldOblique	font-family:DejaVu Sans Condensed;font-weight:bold;font-style:oblique;font-stretch:semi-condensed;
DejaVuSansCondensed-Oblique	DejaVuSansCondensed-Oblique	font-family:DejaVu Sans Condensed;font-style:oblique;font-stretch:semi-condensed;
DejaVuSansMono	DejaVuSansMono	font-family:DejaVu Sans Mono;
DejaVuSansMono-Bold	DejaVuSansMono-Bold	font-family:DejaVu Sans Mono;font-weight:bold;
DejaVuSansMono-BoldOblique	DejaVuSansMono-BoldOblique	font-family:DejaVu Sans Mono;font-weight:bold;font-style:oblique;
DejaVuSansMono-Oblique	DejaVuSansMono-Oblique	font-family:DejaVu Sans Mono;font-style:oblique;
DejaVuSerif	DejaVuSerif	font-family:DejaVu Serif;
DejaVuSerif-Bold	DejaVuSerif-Bold	font-family:DejaVu Serif;font-weight:bold;
DejaVuSerif-BoldItalic	DejaVuSerif-BoldItalic	font-family:DejaVu Serif;font-weight:bold;font-style:italic;
DejaVuSerif-Italic	DejaVuSerif-Italic	font-family:DejaVu Serif;font-style:italic;
DejaVuSerifCondensed	DejaVuSerifCondensed	font-family:DejaVu Serif Condensed;font-stretch:semi-condensed;
DejaVuSerifCondensed-Bold	DejaVuSerifCondensed-Bold	font-family:DejaVu Serif Condensed;font-weight:bold;font-stretch:semi-condensed;
DejaVuSerifCondensed-BoldItalic	DejaVuSerifCondensed-BoldItalic	font-family:DejaVu Serif Condensed;font-weight:bold;font-style:italic;font-stretch:semi-condensed;
DejaVuSerifCondensed-Italic	DejaVuSerifCondensed-Italic	font-family:DejaVu Serif Condensed;font-style:italic;font-stretch:semi-condensed;
DictSym	dictsym	font-family:Dictionary Symbols;
Dingbats	uzdr	font-family:Dingbats;
DomesticManners	Domestic_Manners	font-family:Domestic Manners;
DustismoBold	dustismo_bold	font-family:Dustismo;font-weight:bold;
DustismoBoldItalic	dustismo_bold_italic	font-family:Dustismo;font-weight:bold;font-style:italic;
DustismoItalic	dustismo_italic	font-family:Dustismo;font-style:italic;
DustismoRoman	Dustismo_Roman	font-family:Dustismo Roman;
DustismoRoman-Bold	Dustismo_Roman_Bold	font-family:Dustismo Roman;font-weight:bold;
DustismoRoman-BoldItalic	Dustismo_Roman_Italic_Bold	font-family:Dustismo Roman;font-weight:bold;font-style:italic;
DustismoRoman-Italic	Dustismo_Roman_Italic	font-family:Dustismo Roman;font-style:italic;
EUEX10	euex10	font-family:Euler;font-weight:500;
EUFB10	eufb10	font-family:Euler;font-weight:bold;
EUFB5	eufb5	font-family:Euler;font-weight:bold;
EUFB7	eufb7	font-family:Euler;font-weight:bold;
EUFM10	eufm10	font-family:Euler;font-weight:500;
EUFM5	eufm5	font-family:Euler;font-weight:500;
EUFM7	eufm7	font-family:Euler;font-weight:500;
EURB10	eurb10	font-family:Euler;font-weight:bold;
EURB5	eurb5	font-family:Euler;font-weight:bold;
EURB7	eurb7	font-family:Euler;font-weight:bold;
EURM10	eurm10	font-family:Euler;font-weight:500;
EURM5	eurm5	font-family:Euler;font-weight:500;
EURM7	eurm7	font-family:Euler;font-weight:500;
EUSB10	eusb10	font-family:Euler;font-weight:bold;
EUSB5	eusb5	font-family:Euler;font-weight:bold;
EUSB7	eusb7	font-family:Euler;font-weight:bold;
EUSM10	eusm10	font-family:Euler;font-weight:500;
EUSM5	eusm5	font-family:Euler;font-weight:500;
EUSM7	eusm7	font-family:Euler;font-weight:500;
ElAbogadoLoco	El_Abogado_Loco	font-family:El Abogado Loco;
Epi-Olmec	Epi-Olmec	font-family:Epi-Olmce;font-weight:500;
FIBB84	fibb84	font-family:IbycusHTG Polytonic Greek;font-weight:bold;
Flatline	flatline	font-family:flatline;
FoekFont	FoekFont	font-family:FoekFont;font-weight:500;
Fourier-Alternate-Black	fourier-alt-black	font-family:Fourier-Alternate-Black;font-weight:900;
Fourier-Alternate-Bold	fourier-alt-bold	font-family:Fourier-Alternate-Bold;font-weight:bold;
Fourier-Alternate-BoldItalic	fourier-alt-boldita	font-family:Fourier-Alternate-BoldItalic;font-weight:bold;font-style:italic;
Fourier-Alternate-Italic	fourier-alt-ita	font-family:Fourier-Alternate-Italic;font-style:italic;
Fourier-Alternate-Roman	fourier-alt	font-family:Fourier-Alternate-Roman;
Fourier-Alternate-SemItalic	fourier-alt-semiita	font-family:Fourier-Alternate-SemItalic;font-weight:600;font-style:italic;
Fourier-Alternate-SemiBold	fourier-alt-semi	font-family:Fourier-Alternate-SemiBold;font-weight:600;
Fourier-Math-BlackBoard	fourier-bb	font-family:Fourier-Math-BlackBoard;font-weight:900;
Fourier-Math-Cal	fourier-mcl	font-family:Fourier-Math-Cal;font-style:italic;
Fourier-Math-Extension	fourier-mex	font-family:Fourier-Math-Extension;font-weight:500;
Fourier-Math-Letters	fourier-ml	font-family:Fourier-Math-Letters;
Fourier-Math-Letters-Bold	fourier-mlb	font-family:Fourier-Math-Letters;font-weight:bold;
Fourier-Math-Letters-Bold-Italic	fourier-mlitb	font-family:Fourier-Math-Letters;font-weight:bold;font-style:italic;
Fourier-Math-Letters-Italic	fourier-mlit	font-family:Fourier-Math-Letters;font-style:italic;
Fourier-Math-Symbols	fourier-ms	font-family:Fourier-Math-Symbols;font-style:italic;
FreeEuro	freeeuro	font-family:FreeEuro;font-weight:500;
FreeMonoBold	FreeMonoBold	font-family:FreeMono;font-weight:bold;
FreeMonoBoldOblique	FreeMonoBoldOblique	font-family:FreeMono;font-weight:bold;font-style:oblique;
FreeMonoOblique	FreeMonoOblique	font-family:FreeMono;font-style:oblique;
FreeSansBold	FreeSansBold	font-family:FreeSans;font-weight:bold;
FreeSansBoldOblique	FreeSansBoldOblique	font-family:FreeSans;font-weight:bold;font-style:oblique;
FreeSansOblique	FreeSansOblique	font-family:FreeSans;font-style:oblique;
FreeSerifBold	FreeSerifBold	font-family:FreeSerif;font-weight:bold;
FreeSerifBoldItalic	FreeSerifBoldItalic	font-family:FreeSerif;font-weight:bold;font-style:italic;
FreeSerifItalic	FreeSerifItalic	font-family:FreeSerif;font-style:italic;
Georgia-Bold	Georgia_Bold	font-family:Georgia;font-weight:bold;
Georgia-BoldItalic	Georgia_Bold_Italic	font-family:Georgia;font-weight:bold;font-style:italic;
Georgia-Italic	Georgia_Italic	font-family:Georgia;font-style:italic;
Greek-CourierPlain	grkcurp	font-family:Greek Courier;
HFBR10	hfbr10	font-family:Computer Modern Bright;
HFBR17	hfbr17	font-family:Computer Modern Bright;
HFBR8	hfbr8	font-family:Computer Modern Bright;
HFBR9	hfbr9	font-family:Computer Modern Bright;
HFBRAS10	hfbras10	font-family:Computer Modern Bright;
HFBRAS8	hfbras8	font-family:Computer Modern Bright;
HFBRAS9	hfbras9	font-family:Computer Modern Bright;
HFBRBS10	hfbrbs10	font-family:Computer Modern Bright;
HFBRBS8	hfbrbs8	font-family:Computer Modern Bright;
HFBRBS9	hfbrbs9	font-family:Computer Modern Bright;
HFBRBX10	hfbrbx10	font-family:Computer Modern Bright;font-weight:bold;
HFBRMB10	hfbrmb10	font-family:Computer Modern Bright;font-weight:bold;font-style:italic;
HFBRMI10	hfbrmi10	font-family:Computer Modern Bright;font-style:italic;
HFBRMI8	hfbrmi8	font-family:Computer Modern Bright;font-style:italic;
HFBRMI9	hfbrmi9	font-family:Computer Modern Bright;font-style:italic;
HFBRSL10	hfbrsl10	font-family:Computer Modern Bright;font-style:italic;
HFBRSL17	hfbrsl17	font-family:Computer Modern Bright;font-style:italic;
HFBRSL8	hfbrsl8	font-family:Computer Modern Bright;font-style:italic;
HFBRSL9	hfbrsl9	font-family:Computer Modern Bright;font-style:italic;
HFBRSY10	hfbrsy10	font-family:Computer Modern Bright;font-style:italic;
HFBRSY8	hfbrsy8	font-family:Computer Modern Bright;font-style:italic;
HFBRSY9	hfbrsy9	font-family:Computer Modern Bright;font-style:italic;
HFSLTL10	hfsltl10	font-family:Computer Modern Bright;font-style:italic;
HFTL10	hftl10	font-family:Computer Modern Bright;
IbycusHTG-Regular	IbycusHTG-Regular	font-family:IbycusHTG Polytonic Greek;
Impact	Impact	font-family:Impact;font-stretch:condensed;
Inuit	Inuit	font-family:Inuit;font-weight:500;
Inuit-Bold	Inuitb	font-family:Inuit;font-weight:bold;
Inuit-Bold-Oblique	Inuitbo	font-family:Inuit;font-weight:bold;font-style:oblique;
Inuit-Oblique	Inuito	font-family:Inuit;font-weight:500;font-style:oblique;
Itwasn'tme	It_wasn_t_me	font-family:It wasn't me;
Iwona-Bold	iwonab	font-family:Iwona;font-weight:bold;
Iwona-BoldItalic	Iwona-BoldItalic	font-family:Iwona;font-weight:bold;font-style:italic;
Iwona-Italic	iwonari	font-family:Kurier;font-style:italic;
Iwona-Regular	iwonar	font-family:Iwona;
IwonaCond-Bold	IwonaCond-Bold	font-family:Iwona;font-weight:bold;
IwonaCond-BoldItalic	IwonaCond-BoldItalic	font-family:Iwona;font-weight:bold;font-style:italic;
IwonaCond-Italic	iwonacri	font-family:Iwona;font-style:italic;
IwonaCond-Regular	iwonacr	font-family:Iwona;
IwonaCondHeavy-Italic	IwonaCondHeavy-Italic	font-family:Iwona;font-weight:850;font-style:italic;
IwonaCondHeavy-Regular	IwonaCondHeavy-Regular	font-family:Iwona;font-weight:850;
IwonaCondLight-Italic	IwonaCondLight-Italic	font-family:Iwona;font-weight:300;font-style:italic;
IwonaCondLight-Regular	IwonaCondLight-Regular	font-family:Iwona;font-weight:300;
IwonaCondMedium-Italic	IwonaCondMedium-Italic	font-family:Iwona;font-weight:500;font-style:italic;
IwonaCondMedium-Regular	IwonaCondMedium-Regular	font-family:Iwona;font-weight:500;
IwonaHeavy-Italic	iwonahi	font-family:Iwona;font-weight:800;font-style:italic;
IwonaHeavy-Regular	iwonah	font-family:Iwona;font-weight:800;
IwonaLight-Italic	iwonali	font-family:Iwona;font-weight:200;font-style:italic;
IwonaLight-Regular	iwonal	font-family:Iwona;font-weight:200;
IwonaMedium-Italic	iwonami	font-family:Iwona;font-weight:500;font-style:italic;
IwonaMedium-Regular	iwonam	font-family:Iwona;font-weight:500;
JanaSkrivana	JanaSkrivana	font-family:JanaSkrivana;font-weight:500;
JanaSkrivanaBold	JanaSkrivanaBold	font-family:JanaSkrivana;font-weight:bold;
JanaSkrivanaBoldOblique	JanaSkrivanaBoldSlant	font-family:JanaSkrivana;font-weight:bold;font-style:oblique;
JanaSkrivanaBoldReverseOblique	JanaSkrivanaBoldRslant	font-family:JanaSkrivana;font-weight:bold;font-style:oblique;
JanaSkrivanaOblique	JanaSkrivanaSlant	font-family:JanaSkrivana;font-style:oblique;
JanaSkrivanaReverseOblique	JanaSkrivanaRslant	font-family:JanaSkrivana;font-style:oblique;
Kerkis	Kerkis	font-family:Kerkis;font-weight:500;
Kerkis-Bold	Kerkis-Bold	font-family:Kerkis;font-weight:bold;
Kerkis-BoldItalic	Kerkis-BoldItalic	font-family:Kerkis;font-weight:bold;font-style:italic;
Kerkis-BoldSmallCaps	Kerkis-BoldSmallCaps	font-family:Kerkis;font-weight:bold;font-variant:small-caps;
Kerkis-Calligraphic	Kerkis-Calligraphic	font-family:Kerkis-Calligraphic;font-weight:500;
Kerkis-Italic	Kerkis-Italic	font-family:Kerkis;font-weight:500;font-style:italic;
Kerkis-SemiBold	Kerkis-SemiBold	font-family:Kerkis-SemiBold;font-weight:600;
Kerkis-SemiBold-Italic	Kerkis-SemiBold-Italic	font-family:Kerkis-SemiBold;font-weight:600;font-style:italic;
Kerkis-SmallCaps	Kerkis-SmallCaps	font-family:Kerkis;font-weight:500;font-variant:small-caps;
KerkisSans	KerkisSans	font-family:KerkisSans;font-weight:500;
KerkisSans-Bold	KerkisSans-Bold	font-family:KerkisSans;font-weight:bold;
KerkisSans-BoldItalic	KerkisSans-BoldItalic	font-family:KerkisSans;font-weight:bold;font-style:italic;
KerkisSans-Italic	KerkisSans-Italic	font-family:KerkisSans;font-weight:500;font-style:italic;
KerkisSans-SmallCaps	KerkisSans-SmallCaps	font-family:KerkisSans;font-variant:small-caps;
Ktsy	ktsy	font-family:Ktsy;font-weight:500;
LASY10	lasy10	font-family:LaTeX;font-weight:500;font-style:italic;
LASY5	lasy5	font-family:LaTeX;font-weight:500;font-style:italic;
LASY6	lasy6	font-family:LaTeX;font-weight:500;font-style:italic;
LASY7	lasy7	font-family:LaTeX;font-weight:500;font-style:italic;
LASY8	lasy8	font-family:LaTeX;font-weight:500;font-style:italic;
LASY9	lasy9	font-family:LaTeX;font-weight:500;font-style:italic;
LASYB10	lasyb10	font-family:LaTeX;font-weight:bold;font-style:italic;
LCIRCLE10	lcircle1	font-family:LaTeX;font-weight:500;
LCIRCLEW10	lcirclew	font-family:LaTeX;font-weight:bold;
LCMSS8	lcmss8	font-family:Computer Modern;font-weight:500;
LCMSSB8	lcmssb8	font-family:Computer Modern;font-weight:bold;
LCMSSI8	lcmssi8	font-family:Computer Modern;font-weight:500;font-style:italic;
LINE10	line10	font-family:LaTeX;font-weight:500;
LINEW10	linew10	font-family:LaTeX;font-weight:bold;
LOGO10	logo10	font-family:LOGO10;font-weight:500;
LOGO8	logo8	font-family:LOGO8;font-weight:500;
LOGO9	logo9	font-family:LOGO9;font-weight:500;
LOGOBF10	logobf10	font-family:LOGOBF10;font-weight:bold;
LOGOD10	logod10	font-family:LOGOD10;font-weight:600;
LOGOSL10	logosl10	font-family:LOGOSL10;font-weight:500;font-style:italic;
LOGOSL8	logosl8	font-family:LOGOSL8;font-weight:500;font-style:italic;
LOGOSL9	logosl9	font-family:LOGOSL9;font-weight:500;font-style:italic;
LiberationMono-Bold	LiberationMono-Bold	font-family:Liberation Mono;font-weight:bold;
LiberationMono-BoldItalic	LiberationMono-BoldItalic	font-family:Liberation Mono;font-weight:bold;font-style:italic;
LiberationMono-Italic	LiberationMono-Italic	font-family:Liberation Mono;font-style:italic;
LiberationMono-Regular	LiberationMono-Regular	font-family:Liberation Mono;
LiberationSans-Bold	LiberationSans-Bold	font-family:Liberation Sans;font-weight:bold;
LiberationSans-BoldItalic	LiberationSans-BoldItalic	font-family:Liberation Sans;font-weight:bold;font-style:italic;
LiberationSans-Italic	LiberationSans-Italic	font-family:Liberation Sans;font-style:italic;
LiberationSans-Regular	LiberationSans-Regular	font-family:Liberation Sans;
LiberationSerif-Bold	LiberationSerif-Bold	font-family:Liberation Serif;font-weight:bold;
LiberationSerif-BoldItalic	LiberationSerif-BoldItalic	font-family:Liberation Serif;font-weight:bold;font-style:italic;
LiberationSerif-Italic	LiberationSerif-Italic	font-family:Liberation Serif;font-style:italic;
LiberationSerif-Regular	LiberationSerif-Regular	font-family:Liberation Serif;
LinearA	LinearA	font-family:LinearA;font-weight:500;
LinearACmplxSigns	LinearACmplxSigns	font-family:LinearACmplxSigns;font-weight:500;
LukasSvatba	LukasSvatba	font-family:LukasSvatba;font-weight:500;
LukasSvatbaBold	LukasSvatbaBold	font-family:LukasSvatba;font-weight:bold;
LukasSvatbaBoldOblique	LukasSvatbaBoldSlant	font-family:LukasSvatba;font-weight:bold;font-style:oblique;
LukasSvatbaBoldReverseOblique	LukasSvatbaBoldRslant	font-family:LukasSvatba;font-weight:bold;font-style:oblique;
LukasSvatbaOblique	LukasSvatbaSlant	font-family:LukasSvatba;font-style:oblique;
LukasSvatbaReverseOblique	LukasSvatbaRslant	font-family:LukasSvatba;font-style:oblique;
MSAM10	msam10	font-family:Euler;font-weight:500;
MSAM5	msam5	font-family:Euler;font-weight:500;
MSAM7	msam7	font-family:Euler;font-weight:500;
MSBM10	msbm10	font-family:Euler;font-weight:500;
MSBM5	msbm5	font-family:Euler;font-weight:500;
MSBM7	msbm7	font-family:Euler;font-weight:500;
MarVoSym	marvosym	font-family:Martin Vogel's Symbols;
MarkedFool	MarkedFool	font-family:Marked Fool;
MathDesign-CH-Bold-Extension-10	md-chb7v	font-family:MathDesign-CH;font-weight:bold;
MathDesign-CH-Bold-Italic-MathItalic-10	md-chbi7m	font-family:MathDesign-CH;font-weight:bold;font-style:italic;
MathDesign-CH-Bold-Italic-OT1-10	md-chbi7t	font-family:MathDesign-CH;font-weight:bold;font-style:italic;
MathDesign-CH-Bold-Italic-T1-10	md-chbi8t	font-family:MathDesign-CH;font-weight:bold;font-style:italic;
MathDesign-CH-Bold-Italic-TS1-10	md-chbi8c	font-family:MathDesign-CH;font-weight:bold;font-style:italic;
MathDesign-CH-Bold-MathDesignSymbolA-10	md-chbma	font-family:MathDesign-CH;font-weight:bold;
MathDesign-CH-Bold-MathDesignSymbolB-10	md-chbmb	font-family:MathDesign-CH;font-weight:bold;
MathDesign-CH-Bold-MathItalic-10	md-chb7m	font-family:MathDesign-CH;font-weight:bold;font-style:italic;
MathDesign-CH-Bold-OT1-10	md-chb7t	font-family:MathDesign-CH;font-weight:bold;
MathDesign-CH-Bold-Symbol-10	md-chb7y	font-family:MathDesign-CH;font-weight:bold;font-style:italic;
MathDesign-CH-Bold-T1-10	md-chb8t	font-family:MathDesign-CH;font-weight:bold;
MathDesign-CH-Bold-TS1-10	md-chb8c	font-family:MathDesign-CH;font-weight:bold;
MathDesign-CH-Regular-10	md-chree	font-family:MathDesign-CH;
MathDesign-CH-Regular-Extension-10	md-chr7v	font-family:MathDesign-CH;
MathDesign-CH-Regular-Italic-MathItalic-10	md-chri7m	font-family:MathDesign-CH;font-style:italic;
MathDesign-CH-Regular-Italic-OT1-10	md-chri7t	font-family:MathDesign-CH;font-style:italic;
MathDesign-CH-Regular-Italic-OT1-5	md-chri7t5	font-family:MathDesign-CH;font-style:italic;
MathDesign-CH-Regular-Italic-OT1-6	md-chri7t6	font-family:MathDesign-CH;font-style:italic;
MathDesign-CH-Regular-Italic-OT1-7	md-chri7t7	font-family:MathDesign-CH;font-style:italic;
MathDesign-CH-Regular-Italic-OT1-8	md-chri7t8	font-family:MathDesign-CH;font-style:italic;
MathDesign-CH-Regular-Italic-OT1-9	md-chri7t9	font-family:MathDesign-CH;font-style:italic;
MathDesign-CH-Regular-Italic-T1-10	md-chri8t	font-family:MathDesign-CH;font-style:italic;
MathDesign-CH-Regular-Italic-TS1-10	md-chri8c	font-family:MathDesign-CH;font-style:italic;
MathDesign-CH-Regular-MathDesignSymbolA-10	md-chrma	font-family:MathDesign-CH;
MathDesign-CH-Regular-MathDesignSymbolB-10	md-chrmb	font-family:MathDesign-CH;
MathDesign-CH-Regular-MathItalic-10	md-chr7m	font-family:MathDesign-CH;font-style:italic;
MathDesign-CH-Regular-OT1-10	md-chr7t	font-family:MathDesign-CH;
MathDesign-CH-Regular-OT1-5	md-chr7t5	font-family:MathDesign-CH;
MathDesign-CH-Regular-OT1-6	md-chr7t6	font-family:MathDesign-CH;
MathDesign-CH-Regular-OT1-7	md-chr7t7	font-family:MathDesign-CH;
MathDesign-CH-Regular-OT1-8	md-chr7t8	font-family:MathDesign-CH;
MathDesign-CH-Regular-OT1-9	md-chr7t9	font-family:MathDesign-CH;
MathDesign-CH-Regular-Symbol-10	md-chr7y	font-family:MathDesign-CH;font-style:italic;
MathDesign-CH-Regular-T1-10	md-chr8t	font-family:MathDesign-CH;
MathDesign-CH-Regular-TS1-10	md-chr8c	font-family:MathDesign-CH;
MathDesign-GM-Medium-Extension-10	md-gmm7v	font-family:MathDesign-GM;font-weight:500;
MathDesign-GM-Medium-Italic-MathItalic-10	md-gmmi7m	font-family:MathDesign-GM;font-weight:500;font-style:italic;
MathDesign-GM-Medium-Italic-OT1-10	md-gmmi7t	font-family:MathDesign-GM;font-weight:500;font-style:italic;
MathDesign-GM-Medium-Italic-T1-10	md-gmmi8t	font-family:MathDesign-GM;font-weight:500;font-style:italic;
MathDesign-GM-Medium-Italic-TS1-10	md-gmmi8c	font-family:MathDesign-GM;font-weight:500;font-style:italic;
MathDesign-GM-Medium-MathDesignSymbolA-10	md-gmmma	font-family:MathDesign-GM;font-weight:500;
MathDesign-GM-Medium-MathDesignSymbolB-10	md-gmmmb	font-family:MathDesign-GM;font-weight:500;
MathDesign-GM-Medium-MathItalic-10	md-gmm7m	font-family:MathDesign-GM;font-weight:500;font-style:italic;
MathDesign-GM-Medium-OT1-10	md-gmm7t	font-family:MathDesign-GM;font-weight:500;
MathDesign-GM-Medium-Symbol-10	md-gmm7y	font-family:MathDesign-GM;font-weight:500;font-style:italic;
MathDesign-GM-Medium-T1-10	md-gmm8t	font-family:MathDesign-GM;font-weight:500;
MathDesign-GM-Medium-TS1-10	md-gmm8c	font-family:MathDesign-GM;font-weight:500;
MathDesign-GM-Regular-Extension-10	md-gmr7v	font-family:MathDesign-GM;
MathDesign-GM-Regular-Italic-MathItalic-10	md-gmri7m	font-family:MathDesign-GM;font-style:italic;
MathDesign-GM-Regular-Italic-OT1-10	md-gmri7t	font-family:MathDesign-GM;font-style:italic;
MathDesign-GM-Regular-Italic-T1-10	md-gmri8t	font-family:MathDesign-GM;font-style:italic;
MathDesign-GM-Regular-Italic-TS1-10	md-gmri8c	font-family:MathDesign-GM;font-style:italic;
MathDesign-GM-Regular-MathDesignSymbolA-10	md-gmrma	font-family:MathDesign-GM;
MathDesign-GM-Regular-MathDesignSymbolB-10	md-gmrmb	font-family:MathDesign-GM;
MathDesign-GM-Regular-MathItalic-10	md-gmr7m	font-family:MathDesign-GM;font-style:italic;
MathDesign-GM-Regular-OT1-10	md-gmr7t	font-family:MathDesign-GM;
MathDesign-GM-Regular-Symbol-10	md-gmr7y	font-family:MathDesign-GM;font-style:italic;
MathDesign-GM-Regular-T1-10	md-gmr8t	font-family:MathDesign-GM;
MathDesign-GM-Regular-TS1-10	md-gmr8c	font-family:MathDesign-GM;
MathDesign-UT-Bold-Extension-10	md-utb7v	font-family:MathDesign-UT;font-weight:bold;
MathDesign-UT-Bold-Italic-MathItalic-10	md-utbi7m	font-family:MathDesign-UT;font-weight:bold;font-style:italic;
MathDesign-UT-Bold-Italic-OT1-10	md-utbi7t	font-family:MathDesign-UT;font-weight:bold;font-style:italic;
MathDesign-UT-Bold-Italic-T1-10	md-utbi8t	font-family:MathDesign-UT;font-weight:bold;font-style:italic;
MathDesign-UT-Bold-Italic-TS1-10	md-utbi8c	font-family:MathDesign-UT;font-weight:bold;font-style:italic;
MathDesign-UT-Bold-MathDesignSymbolA-10	md-utbma	font-family:MathDesign-UT;font-weight:bold;
MathDesign-UT-Bold-MathDesignSymbolB-10	md-utbmb	font-family:MathDesign-UT;font-weight:bold;
MathDesign-UT-Bold-MathItalic-10	md-utb7m	font-family:MathDesign-UT;font-weight:bold;font-style:italic;
MathDesign-UT-Bold-OT1-10	md-utb7t	font-family:MathDesign-UT;font-weight:bold;
MathDesign-UT-Bold-Symbol-10	md-utb7y	font-family:MathDesign-UT;font-weight:bold;font-style:italic;
MathDesign-UT-Bold-T1-10	md-utb8t	font-family:MathDesign-UT;font-weight:bold;
MathDesign-UT-Bold-TS1-10	md-utb8c	font-family:MathDesign-UT;font-weight:bold;
MathDesign-UT-Regular-Extension-10	md-utr7v	font-family:MathDesign-UT;
MathDesign-UT-Regular-Italic-MathItalic-10	md-utri7m	font-family:MathDesign-UT;font-style:italic;
MathDesign-UT-Regular-Italic-OT1-10	md-utri7t	font-family:MathDesign-UT;font-style:italic;
MathDesign-UT-Regular-Italic-T1-10	md-utri8t	font-family:MathDesign-UT;font-style:italic;
MathDesign-UT-Regular-Italic-TS1-10	md-utri8c	font-family:MathDesign-UT;font-style:italic;
MathDesign-UT-Regular-MathDesignSymbolA-10	md-utrma	font-family:MathDesign-UT;
MathDesign-UT-Regular-MathDesignSymbolB-10	md-utrmb	font-family:MathDesign-UT;
MathDesign-UT-Regular-MathItalic-10	md-utr7m	font-family:MathDesign-UT;font-style:italic;
MathDesign-UT-Regular-OT1-10	md-utr7t	font-family:MathDesign-UT;
MathDesign-UT-Regular-Symbol-10	md-utr7y	font-family:MathDesign-UT;font-style:italic;
MathDesign-UT-Regular-T1-10	md-utr8t	font-family:MathDesign-UT;
MathDesign-UT-Regular-TS1-10	md-utr8c	font-family:MathDesign-UT;
NimbusMonL-Bold	ucrb8a	font-family:Nimbus Mono L;font-weight:bold;
NimbusMonL-BoldObli	ucrbo8a	font-family:Nimbus Mono L;font-weight:bold;font-style:oblique;
NimbusMonL-Regu	ucrr8a	font-family:Nimbus Mono L;
NimbusMonL-ReguObli	ucrro8a	font-family:Nimbus Mono L;font-style:oblique;
NimbusRomNo9L-Medi	utmb8a	font-family:Nimbus Roman No9 L;font-weight:500;
NimbusRomNo9L-MediItal	utmbi8a	font-family:Nimbus Roman No9 L;font-weight:500;font-style:italic;
NimbusRomNo9L-Regu	utmr8a	font-family:Nimbus Roman No9 L;
NimbusRomNo9L-ReguItal	utmri8a	font-family:Nimbus Roman No9 L;font-style:italic;
NimbusSanL-Bold	uhvb8a	font-family:Nimbus Sans L;font-weight:bold;
NimbusSanL-BoldCond	uhvbrc8a	font-family:Nimbus Sans L;font-weight:bold;
NimbusSanL-BoldCondItal	uhvboc8a	font-family:Nimbus Sans L;font-weight:bold;font-style:italic;
NimbusSanL-BoldItal	uhvbo8a	font-family:Nimbus Sans L;font-weight:bold;font-style:italic;
NimbusSanL-Regu	uhvr8a	font-family:Nimbus Sans L;
NimbusSanL-ReguCond	uhvrrc8a	font-family:Nimbus Sans L;
NimbusSanL-ReguCondItal	uhvroc8a	font-family:Nimbus Sans L;font-style:italic;
NimbusSanL-ReguItal	uhvro8a	font-family:Nimbus Sans L;font-style:italic;
OmegaDingbats	omding	font-family:OmegaDingbats;font-weight:500;
OmegaSansTifinagh	omssti	font-family:OmegaSansTifinagh;font-weight:500;
OmegaSerifArabicOne	omsea1	font-family:OmegaSerifArabicOne;font-weight:500;
OmegaSerifArabicOne-Bold	omsea1b	font-family:OmegaSerifArabicOne;font-weight:bold;
OmegaSerifArabicThree	omsea3	font-family:OmegaSerifArabicThree;font-weight:500;
OmegaSerifArabicThree-Bold	omsea3b	font-family:OmegaSerifArabicThree;font-weight:bold;
OmegaSerifArabicTwo	omsea2	font-family:OmegaSerifArabicTwo;font-weight:500;
OmegaSerifArabicTwo-Bold	omsea2b	font-family:OmegaSerifArabicTwo;font-weight:bold;
OmegaSerifArmenian	omseha	font-family:OmegaSerifArmenian;font-weight:500;
OmegaSerifCommon	omseco	font-family:OmegaSerifCommon;font-weight:500;
OmegaSerifCommon-Bold	omsecob	font-family:OmegaSerifCommon;font-weight:bold;
OmegaSerifCommon-BoldItalic	omsecobi	font-family:OmegaSerifCommon;font-weight:bold;font-style:italic;
OmegaSerifCommon-Italic	omsecoi	font-family:OmegaSerifCommon;font-weight:500;font-style:italic;
OmegaSerifCyrillic	omsecy	font-family:OmegaSerifCyrillic;font-weight:500;
OmegaSerifCyrillic-Bold	omsecyb	font-family:OmegaSerifCyrillic;font-weight:bold;
OmegaSerifCyrillic-Italic	omsecyi	font-family:OmegaSerifCyrillic;font-weight:500;font-style:italic;
OmegaSerifCyrillicExtended	omsecx	font-family:OmegaSerifCyrillicExtended;font-weight:500;
OmegaSerifGreek	omsegr	font-family:OmegaSerifGreek;font-weight:500;
OmegaSerifGreek-Bold	omsegrb	font-family:OmegaSerifGreek;font-weight:bold;
OmegaSerifGreek-BoldItalic	omsegrbi	font-family:OmegaSerifGreek;font-weight:bold;font-style:italic;
OmegaSerifGreek-Italic	omsegri	font-family:OmegaSerifGreek;font-weight:500;font-style:italic;
OmegaSerifHebrew	omsehe	font-family:OmegaSerifHebrew;font-weight:500;
OmegaSerifIPA	omseip	font-family:OmegaSerifIPA;font-weight:500;
OmegaSerifLatin	omsela	font-family:OmegaSerifLatin;font-weight:500;
OmegaSerifLatin-Bold	omselab	font-family:OmegaSerifLatin;font-weight:bold;
OmegaSerifLatin-BoldItalic	omselabi	font-family:OmegaSerifLatin;font-weight:bold;font-style:italic;
OmegaSerifLatin-Italic	omselai	font-family:OmegaSerifLatin;font-weight:500;font-style:italic;
OmegaSerifTifinagh	omseti	font-family:OmegaSerifTifinagh;font-weight:500;
OpenSymbol	opens___	font-family:OpenSymbol;
PazoMath	fplmr	font-family:PazoMath;
PazoMath-Bold	fplmb	font-family:PazoMath;font-weight:bold;
PazoMath-BoldItalic	fplmbi	font-family:PazoMath;font-weight:bold;font-style:italic;
PazoMath-Italic	fplmri	font-family:PazoMath;font-style:italic;
PazoMathBlackboardBold	fplmbb	font-family:PazoMathBlackboardBold;font-weight:bold;
PenguinAttack	PenguinAttack	font-family:Penguin Attack;
Pxbex	pxbex	font-family:Pxbex;font-weight:500;
Pxbexa	pxbexa	font-family:Pxbexa;font-weight:500;
Pxbmia	pxbmia	font-family:Pxbmia;font-weight:500;
Pxbsy	pxbsy	font-family:Pxbsy;font-weight:500;
Pxbsya	pxbsya	font-family:Pxbsya;font-weight:500;
Pxbsyb	pxbsyb	font-family:Pxbsyb;font-weight:500;
Pxbsyc	pxbsyc	font-family:Pxbsyc;font-weight:500;
Pxex	pxex	font-family:Pxex;font-weight:500;
Pxexa	pxexa	font-family:Pxexa;font-weight:500;
Pxmia	pxmia	font-family:Pxmia;font-weight:500;
Pxsy	pxsy	font-family:Pxsy;font-weight:500;
Pxsya	pxsya	font-family:Pxsya;font-weight:500;
Pxsyb	pxsyb	font-family:Pxsyb;font-weight:500;
Pxsyc	pxsyc	font-family:Pxsyc;font-weight:500;
Rpcxb	rpcxb	font-family:Rpcxb;font-weight:500;
Rpcxbi	rpcxbi	font-family:Rpcxbi;font-weight:500;
Rpcxi	rpcxi	font-family:Rpcxi;font-weight:500;
Rpcxr	rpcxr	font-family:Rpcxr;font-weight:500;
Rpxb	rpxb	font-family:Rpxb;font-weight:500;
Rpxbi	rpxbi	font-family:Rpxbi;font-weight:500;
Rpxbmi	rpxbmi	font-family:Rpxbmi;font-weight:500;
Rpxbsc	rpxbsc	font-family:Rpxbsc;font-weight:500;
Rpxi	rpxi	font-family:Rpxi;font-weight:500;
Rpxmi	rpxmi	font-family:Rpxmi;font-weight:500;
Rpxr	rpxr	font-family:Rpxr;font-weight:500;
Rpxsc	rpxsc	font-family:Rpxsc;font-weight:500;
StandardSymL	usyr	font-family:Standard Symbols L;
Tapir	tap	font-family:Tapir;
TeX-cmex7	fmex7	font-family:TeX cmex7;
TeX-cmex8	fmex8	font-family:TeX cmex8;
TeX-cmex9	fmex9	font-family:TeX cmex9;
TeX-copti	copti	font-family:TeX copti;
TeX-copto	copto	font-family:TeX copto;
TeX-feybl10	geybl10	font-family:TeX feybl10;
TeX-feybo10	geybo10	font-family:TeX feybo10;
TeX-feybr10	geybr10	font-family:TeX feybr10;
TeX-feyml10	geyml10	font-family:TeX feyml10;
TeX-feymo10	geymo10	font-family:TeX feymo10;
TeX-feymr10	geymr10	font-family:TeX feymr10;
TeX-vect10	vect10	font-family:TeX vect10;
TeX-vect5	vect5	font-family:TeX vect5;
TeX-vect6	vect6	font-family:TeX vect6;
TeX-vect7	vect7	font-family:TeX vect7;
TeX-vect8	vect8	font-family:TeX vect8;
TeX-vect9	vect9	font-family:TeX vect9;
TeXPalladioL-BoldItalicOsF	fplbij8a	font-family:TeX Palladio L;font-weight:bold;font-style:italic;
TeXPalladioL-BoldOsF	fplbj8a	font-family:TeX Palladio L;font-weight:bold;
TeXPalladioL-ItalicOsF	fplrij8a	font-family:TeX Palladio L;font-style:italic;
TeXPalladioL-SC	fplrc8a	font-family:TeX Palladio L;
TimesNewRomanPS-BoldItalicMT	Times_New_Roman_Bold_Italic	font-family:Times New Roman;font-weight:bold;font-style:italic;
TimesNewRomanPS-BoldMT	Times_New_Roman_Bold	font-family:Times New Roman;font-weight:bold;
TimesNewRomanPS-ItalicMT	Times_New_Roman_Italic	font-family:Times New Roman;font-style:italic;
TimesNewRomanPSMT	Times_New_Roman	font-family:Times New Roman;
Trajan-Roman	trjnr10	font-family:Trajan;
Trajan-Slanted	trjnsl10	font-family:Trajan;font-style:oblique;
Trebuchet-BoldItalic	Trebuchet_MS_Bold_Italic	font-family:Trebuchet MS;font-weight:bold;font-style:italic;
TrebuchetMS	Trebuchet_MS	font-family:Trebuchet MS;
TrebuchetMS-Bold	Trebuchet_MS_Bold	font-family:Trebuchet MS;font-weight:bold;
TrebuchetMS-Italic	Trebuchet_MS_Italic	font-family:Trebuchet MS;font-style:italic;
URWAntiquaT-RegularCondensed	uaqr8ac	font-family:URW Antiqua T;font-stretch:condensed;
URWBookmanL-DemiBold	ubkd8a	font-family:URW Bookman L;font-weight:600;
URWBookmanL-DemiBoldItal	ubkdi8a	font-family:URW Bookman L;font-weight:600;font-style:italic;
URWBookmanL-Ligh	ubkl8a	font-family:URW Bookman L;
URWBookmanL-LighItal	ubkli8a	font-family:URW Bookman L;font-style:italic;
URWChanceryL-MediItal	z003034l	font-family:URW Chancery L;font-weight:500;font-style:italic;
URWGothicL-Book	uagk8a	font-family:URW Gothic L;
URWGothicL-BookObli	uagko8a	font-family:URW Gothic L;font-style:oblique;
URWGothicL-Demi	uagd8a	font-family:URW Gothic L;font-weight:600;
URWGothicL-DemiObli	uagdo8a	font-family:URW Gothic L;font-weight:600;font-style:oblique;
URWGroteskT-Bold	ugqb8a	font-family:URW Grotesk T;font-weight:bold;
URWPalladioL-Bold	uplb8a	font-family:URW Palladio L;font-weight:bold;
URWPalladioL-BoldItal	uplbi8a	font-family:URW Palladio L;font-weight:bold;font-style:italic;
URWPalladioL-Ital	uplri8a	font-family:URW Palladio L;font-style:italic;
URWPalladioL-Roma	uplr8a	font-family:URW Palladio L;
Utopia-Bold	putb8a	font-family:Utopia;font-weight:bold;
Utopia-BoldItalic	putbi8a	font-family:Utopia;font-weight:bold;font-style:italic;
Utopia-Italic	putri8a	font-family:Utopia;font-style:italic;
Utopia-Regular	putr8a	font-family:Utopia;
Verdana-Bold	Verdana_Bold	font-family:Verdana;font-weight:bold;
Verdana-BoldItalic	Verdana_Bold_Italic	font-family:Verdana;font-weight:bold;font-style:italic;
Verdana-Italic	Verdana_Italic	font-family:Verdana;font-style:italic;
WNCYB10	wncyb10	font-family:AMS;font-weight:bold;
WNCYI10	wncyi10	font-family:AMS;font-weight:500;font-style:italic;
WNCYR10	wncyr10	font-family:AMS;font-weight:500;
WNCYSC10	wncysc10	font-family:AMS;font-weight:500;
WNCYSS10	wncyss10	font-family:AMS;font-weight:500;
XYATIP10	xyatip10	font-family:XYATIP;font-weight:500;
XYBSQL10	xybsql10	font-family:XYBSQL;font-weight:500;
XYBTIP10	xybtip10	font-family:XYBTIP;font-weight:500;
XYCIRC10	xycirc10	font-family:XYCIRC;font-weight:500;
XYCMAT10	xycmat10	font-family:XYCMAT;font-weight:500;
XYCMBT10	xycmbt10	font-family:XYCMBT;font-weight:500;
XYDASH10	xydash10	font-family:XYDASH;font-weight:500;
XYEUAT10	xyeuat10	font-family:XYEUAT;font-weight:500;
XYEUBT10	xyeubt10	font-family:XYEUBT;font-weight:500;
cmllbx10	cmllbx10	font-family:CMLL;font-weight:bold;
cmllbx5	cmllbx5	font-family:CMLL;font-weight:bold;
cmllbx6	cmllbx6	font-family:CMLL;font-weight:bold;
cmllbx7	cmllbx7	font-family:CMLL;font-weight:bold;
cmllbx8	cmllbx8	font-family:CMLL;font-weight:bold;
cmllbx9	cmllbx9	font-family:CMLL;font-weight:bold;
cmllr10	cmllr10	font-family:CMLL;
cmllr5	cmllr5	font-family:CMLL;
cmllr6	cmllr6	font-family:CMLL;
cmllr7	cmllr7	font-family:CMLL;
cmllr8	cmllr8	font-family:CMLL;
cmllr9	cmllr9	font-family:CMLL;
cmllss10	cmllss10	font-family:CMLL Sans;
cmllss8	cmllss8	font-family:CMLL Sans;
cmllss9	cmllss9	font-family:CMLL Sans;
cmllssbx10	cmllssbx10	font-family:CMLL Sans;font-weight:bold;
eullbx10	eullbx10	font-family:EuLL;font-weight:bold;
eullbx5	eullbx5	font-family:EuLL;font-weight:bold;
eullbx6	eullbx6	font-family:EuLL;font-weight:bold;
eullbx7	eullbx7	font-family:EuLL;font-weight:bold;
eullbx8	eullbx8	font-family:EuLL;font-weight:bold;
eullbx9	eullbx9	font-family:EuLL;font-weight:bold;
eullr10	eullr10	font-family:EuLL;
eullr5	eullr5	font-family:EuLL;
eullr6	eullr6	font-family:EuLL;
eullr7	eullr7	font-family:EuLL;
eullr8	eullr8	font-family:EuLL;
eullr9	eullr9	font-family:EuLL;
fruamn	fruamn8z	font-family:fruamn;
fruann	fruann8z	font-family:fruann;
frucmn	frucmn8z	font-family:frucmn;
frucnn	frucnn8z	font-family:frucnn;
frulmn	frulmn8z	font-family:frulmn;
frulnm	frulnm8z	font-family:frulnm;
frulnn	frulnn8z	font-family:frulnn;
frulnr	frulnr8z	font-family:frulnr;
frulns	frulns8z	font-family:frulns;
frummn	frummn8z	font-family:frummn;
frumnn	frumnn8z	font-family:frumnn;
frunbn	frunbn8z	font-family:frunbn;
frunln	frunln8z	font-family:frunln;
frunmm	frunmm8z	font-family:frunmm;
frunmn	frunmn8z	font-family:frunmn;
frunmr	frunmr8z	font-family:frunmr;
frunms	frunms8z	font-family:frunms;
frunnn	frunnn8z	font-family:frunnn;
frutmn	frutmn8z	font-family:frutmn;
frutnn	frutnn8z	font-family:frutnn;
manfnt	manfnt	font-family:manfnt;font-weight:500;
phaistos	phaistos	font-family:phaistos;font-weight:500;
rblmi	rblmi	font-family:rblmi;font-style:italic;
rsfs10	rsfs10	font-family:rsfs10;font-style:italic;
rsfs5	rsfs5	font-family:rsfs5;font-weight:500;font-style:italic;
rsfs7	rsfs7	font-family:rsfs7;font-style:italic;
rtcxb	rtcxb	font-family:rtcxb;font-weight:500;
rtcxbi	rtcxbi	font-family:rtcxbi;font-weight:500;
rtcxbss	rtcxbss	font-family:rtcxbss;font-weight:500;
rtcxi	rtcxi	font-family:rtcxi;font-weight:500;
rtcxr	rtcxr	font-family:rtcxr;font-weight:500;
rtcxss	rtcxss	font-family:rtcxss;font-weight:500;
rtxb	rtxb	font-family:rtxb;font-weight:500;
rtxbi	rtxbi	font-family:rtxbi;font-weight:500;
rtxbmi	rtxbmi	font-family:rtxbmi;font-weight:500;
rtxbsc	rtxbsc	font-family:rtxbsc;font-weight:500;
rtxbss	rtxbss	font-family:rtxbss;font-weight:500;
rtxbsssc	rtxbsssc	font-family:rtxbsssc;font-weight:500;
rtxi	rtxi	font-family:rtxi;font-weight:500;
rtxmi	rtxmi	font-family:rtxmi;font-weight:500;
rtxr	rtxr	font-family:rtxr;font-weight:500;
rtxsc	rtxsc	font-family:rtxsc;font-weight:500;
rtxss	rtxss	font-family:rtxss;font-weight:500;
rtxsssc	rtxsssc	font-family:rtxsssc;font-weight:500;
t1xbtt	t1xbtt	font-family:t1xbtt;font-weight:500;
t1xbttsc	t1xbttsc	font-family:t1xbttsc;font-weight:500;
t1xtt	t1xtt	font-family:t1xtt;font-weight:500;
t1xttsc	t1xttsc	font-family:t1xttsc;font-weight:500;
tcxbtt	tcxbtt	font-family:tcxbtt;font-weight:500;
tcxtt	tcxtt	font-family:tcxtt;font-weight:500;
txbex	txbex	font-family:txbex;font-weight:500;
txbexa	txbexa	font-family:txbexa;font-weight:500;
txbmia	txbmia	font-family:txbmia;font-weight:500;
txbsy	txbsy	font-family:txbsy;font-weight:500;
txbsya	txbsya	font-family:txbsya;font-weight:500;
txbsyb	txbsyb	font-family:txbsyb;font-weight:500;
txbsyc	txbsyc	font-family:txbsyc;font-weight:500;
txbtt	txbtt	font-family:txbtt;font-weight:500;
txbttsc	txbttsc	font-family:txbttsc;font-weight:500;
txex	txex	font-family:txex;font-weight:500;
txexa	txexa	font-family:txexa;font-weight:500;
txmia	txmia	font-family:txmia;font-weight:500;
txsy	txsy	font-family:txsy;font-weight:500;
txsya	txsya	font-family:txsya;font-weight:500;
txsyb	txsyb	font-family:txsyb;font-weight:500;
txsyc	txsyc	font-family:txsyc;font-weight:500;
txtt	txtt	font-family:txtt;font-weight:500;
txttsc	txttsc	font-family:txttsc;font-weight:500;
wasy5	wasy5	font-family:wasy5;font-weight:500;
wasy6	wasy6	font-family:wasy6;font-weight:500;
wasy7	wasy7	font-family:wasy7;font-weight:500;
wasy8	wasy8	font-family:wasy8;font-weight:500;
wasy9	wasy9	font-family:wasy9;font-weight:500;
wasyb10	wasyb10	font-family:wasyb10;font-weight:bold;
yfrak-Regular	yfrak	font-family:yfrak;
ygoth-Regular	ygoth	font-family:ygoth;
yswab-Regular	yswab	font-family:yswab;
